	NO ./texture/red_wall.xpm

   
                       SO ./texture/woddy.xpm
       
WE                   ./texture/gree_wall.xpm
    
                         
EA                 ./texture/black_wall.xpm


C                128,                   0,                                   235                  
F 	111            ,               54             ,           8

111111111111
100100000001
10000N001001
111111111111