NO ./texture/red_wall.xpm
SO ./texture/bleu_wall.xpm








WE ./texture/gree_wall.xpm
EA ./texture/black_wall.xpm
C 135,206,235
F 128,128,128



111111111111111111111111111111111
100000000000000000000000000000001
100000000000000000000000000000001
100000000000000000000000000000001
100000000000000000000000000000001
100000000000000000000000000000001
100000000000100000000000000000001
100000000000100000000000000000001
100000000000100000000000110000001
100000000000000000000000110000001
100000000000000000000000110000001
100000000010000000000000110000001
100000000010000010000000000000001
100000000010000010000000000000001
100000000010000010000000000000001
100000000001000000000000000000001
100000000000100000000010000000001
100000000000010000000010000000001
100000000000000000000010000000001
1000010000000000N0000010000000001
100001000000000000000000000000001
100001010000000000000000000000001
100000010000000000000000000000001
100000000000000000000000000000001
100000000000000000000000000000001
100000000000000000000000000000001
100000000000000000000000000000001
111111111111111111111111111111111

