NO ./texture/redwall.xpm

   
                       SO ./texture/bleu_wall.xpm
       
WE                   ./texture/gree_wall.xpm
    
                         
EA                 ./texture/black_wall.xpm


C                128,                   0,                                   235                  
F 	111            ,               54             ,           8

111111111111
1001    1N11
111111111111