NO ./texture/red_wall.xpm
SO ./texture/bleu_wall.xpm
WE ./texture/gree_wall.xpm
EA ./texture/black_wall.xpm
C 135,206,235
F 128,128,128
                   111111
                   100101
1111111111111111111100001
1000000000000000000101001
1100N11111111111111111111
1111111111111111111111111
